########################################################################################################################
#                                                                                                                      #
#     #                ###                                                                                             #
#                                                                                                                      #
#         #########                                        ###                                                         #
#         #       #                                                                                                    #
#                 #                                                                                                    #
#   #             #    ##               ##                                        ###                                  #
#         #       #                                              ##                                                    #
#         #########                                                                                                    #
####      #         ##                          #########                                                              #
######                  #                       #       #                       #                                      #
########                                        #       #                                                              #
#                       """""""""""""""##               #             o                                                #
#                       """""""""""""""         #       #                   ##                                         #
#                       """""""""""""""         #########                                                              #
#                                                                                                                      #
#                                                                                                                      #
#                         ##                #                                          ###                             #
#              #        ####                                          #                                                #
#                                 o                                                                                    #
#        o                                                         ##                                                  #
#                                           #########                ##                                                #
#         ###  ###   #                      #       #                                                                  #
#        ##      ##                                 #                                      ##                          #
#       ##        ##                                #                          ##                                      #
#      ##          ##                       #       #                                                                  #
#########           ##                      #########                                 ##                               #
#                    #                                                                                                 #
#                    #                                              ##                                                 #
########################################################################################################################
